 ##   #
  #   #
# #   #
  #   #
      #
#######